000000000001000000
000000000002220000
000000100000000000
000000222000000000
000010000000000000
002220000010000000
000000000222000000
000000000000000000
111111111111111111